D------------------------------------------------------------------------------------------------------------------------------------------------
D------------------------------------------------------------------------------------------------------------------------------------------------
D------------------------------------------------------------------------------------------------------------------------------------------------
D------------------------------------------------------------------------------------------------------------------------------------------------
D------------------------------------------------------------------------------------------------------------------------------------------------
D------------------------------------------------------------------------------------------------------------------------------------------------
D------------------------------------------------------------------------------------------------------------------------------------------------
D------------------------------------------------------------------------------------------------------------------------------------------------
D------------------------------------------------------------------------------------------------------------------------------------------------
D--------------------------------------------------------------------V---------------------------------------------------------------------------
D------------------------------------------------------------------------------------------------------------------------------------------------
D------------------------------------------------------------------------------------------------------------------------------------------------
D-------------------------------------------------------ETTTTA----------------w------------------------------------------------------------------
D------------------------------------------------------------------------------------------------------------------------------------------------
D------------------------------------------------------------------------------------------------------------------------------------------------
D-----------------------------------ETTA--------------------------ETTTA--------------------------------------------------------------------------
D----------------------------------------------------------------------------------------------------------------------X-------------------------
D-------------------------ETTTA------------------ETTTTTA--------------------ETTTA----------------------------------------------------------------
D-----------------------------------------------------------------------------------------------X----------------PGGGGGGGGGGGGGGGGGGGC-------l---
D------------------------------------------------------------------------------------------------------------PGGGRDDDDDDDDDDDDDDDDDDDI-----------
DGGGGGGGGGC---PGGGGGGC------PGGGGGGGGGC--PGGGGGGGGGGGGGGGGGC-------------------------------PGGGGGGGGGGGGGGGGGRDDDDDDDDDDDDDDDDDDDDDDDLGGGGGGGGGGG
DDDDDDDDDDI---JDDDDDDLGGGGGGRDDDDDDDDDI--JDDDDDDDDDDDDDDDDDI-------------------------------JDDDDDDDDDDDDDDDDDDDDDDDDDDDDDDDDDDDDDDDDDDDDDDDDDDDDD
DDDDDDDDDDI---JDDDDDDDDDDDDDDDDDDDDDDDI--JDDDDDDDDDDDDDDDDDI-------------------------------JDDDDDDDDDDDDDDDDDDDDDDDDDDDDDDDDDDDDDDDDDDDDDDDDDDDDD
D--------DI---JDD-------------------DDI--JDD-------------DDI-------------------------------JDD---------------------------------------------------
ZZZZZZZZZZZZZZZZZZZZZZZZZZZZZZZZZZZZZZZZZZZZZZZZZZZZZZZZZZZZZZZZZZZZZZZZZZZZZZZZZZZZZZZZZZZZZZZZZZZZZZZZZZZZZZZZZZZZZZZZZZZZZZZZZZZZZZZZZZZZZZZZZ