--------------------
--------------------
----------------TTT-
----TTTT------------
-P-----------P------
-TT---------TTT-----
--------P-----------
-----TTTTT------A---
----------------A---
TTTTTTTTTTTTTTTTTTTT
TTTTTTTTTTTTTTTTTTTT
TTTTTTTTTTTTTTTTTTTT