-----------------------l----------------
-------------------------------------l--
-------w------w-----------------w-------
------------------------X---------------
----------------------------------------
----------------------ETTTA-------------
-------S-----------------------------X--
----------------------------------------
----------------ETA-----------------ETA-
-------------------------X--------------
----------------------------------------
----ETTA----------------ETTA------------
---------------------------------X------
----------------------------------------
-EA---------ETA------EA---------ETA-----
----------------------------------------
----------------------------------------
-----ETTTA---------------ETTTA------------------
-------------------------------------------X----
------------------------------------------------
GGGGGGGGGC---PGGGGGGC------PGGGGGGGGGC--PGGGGGGC
DDDDDDDDDI---JDDDDDDLGGGGGGRDDDDDDDDDI--JDDDDDDL
DDDDDDDDDI---JDDDDDDDDDDDDDDDDDDDDDDDI--JDDDDDDD
DDDDDDDDDI---JDDDDDDDDDDDDDDDDDDDDDDDI--JDDDDDDD