--------------------
--------------------
----------------TTT-
----TTTT------------
--------------------
-TT---------TTT-----
--------------------
-----TTTTT------T---
----------------D---
TTTTTTTTTTTTTTTTDTTT
DDDDDDDDDDDDDDDDDDDD
DDDDDDDDDDDDDDDDDDDD