----------------------------------------
----------------------------------------
----------------------------------------
----------------------------------------
----------------------------------------
----------------------------------------
----------------------------------------
----------------------------------------
----------------------------------------
----------------------------------------
----------------------S-----------------
-------S--------------------------------
----------------------------------------
----------------ETA-----------------ETA-
----ETTA----------------ETTA------------
----------------------------------------
-EA---------ETA------EA---------ETA-----
----------------------------------------
-----ETTTA---------------ETTTA----------
----------------------------------------
GGGGGGGGGGGGGGGGGGGGC------PGGGGGGGGGGGG
DDDDDDDDDDDDDDDDDDDDLGGGGGGRDDDDDDDDDDDD
DDDDDDDDDDDDDDDDDDDDDDDDDDDDDDDDDDDDDDDD
DDDDDDDDDDDDDDDDDDDDDDDDDDDDDDDDDDDDDDDD