----------------------------------------
----------------------------------------
----------------------------------------
----------------------------------------
----------------------------------------
----------------------S-----------------
-------S--------------------------------
----------------------------------------
----------------ETA-----------------ETA-
----------------------------------------
----------------------------------------
----ETTA----------------ETTA------------
----------------------------------------
----------------------------------------
-EA---------ETA------EA---------ETA-----
----------------------------------------
----------------------------------------
-----ETTTA---------------ETTTA----------
----------------------------------------
----------------------------------------
GGGGGGGGGC---PGGGGGGC------PGGGGGGGGGGGG
DDDDDDDDDL---RDDDDDDLGGGGGGRDDDDDDDDDDDD
DDDDDDDDDL---RDDDDDDDDDDDDDDDDDDDDDDDDDD
DDDDDDDDDL---RDDDDDDDDDDDDDDDDDDDDDDDDDD