----------------------------------------
----------------------------------------
----------------------------------------
----------------------------------------
----------------------------------------
----------------------ETTTA-------------
-------S--------------------------------
----------------------------------------
----------------ETA-----------------ETA-
----------------------------------------
----------------------------------------
----ETTA----------------ETTA------------
----------------------------------------
----------------------------------------
-EA---------ETA------EA---------ETA-----
----------------------------------------
----------------------------------------
-----ETTTA---------------ETTTA----------
----------------------------------------
----------------------------------------
GGGGGGGGGC---PGGGGGGC------PGGGGGGGGGC--PGGGGGGC
DDDDDDDDDI---JDDDDDDLGGGGGGRDDDDDDDDDI--JDDDDDDL
DDDDDDDDDI---JDDDDDDDDDDDDDDDDDDDDDDDI--JDDDDDDD
DDDDDDDDDI---JDDDDDDDDDDDDDDDDDDDDDDDI--JDDDDDDD